OBJECTID,stormid,month,year,AcresOnLand,Shape__Area,Shape__Length,Total_Store_Count,HD_Store_Count,LOW_Store_Count
1,al012014,07,2014,7348932.37555123,73.0840850798879,58.7512062406434,30,12,18
2,al012015,05,2015,5592854.61281415,20.0953605298596,19.4817962053996,16,6,10
3,al012016,01,2016,544450.772567228,148.734281891138,75.3318884861288,0,0,0
4,al012017,04,2017,0,25.0414153722114,42.07385029007,0,0,0
5,AL012018,05,2018,9951669.85716189,26.8549176747248,30.945150780234,16,5,11
6,AL012019,05,2019,0,2.57965969077998,9.85228182799212,0,0,0
7,AL012020,05,2020,196106.080429299,100.873021354902,60.3771771366169,2,1,1
8,AL012021,05,2021,0,76.1900546060949,51.7320229168157,0,0,0
9,AL012022,06,2022,13321873.6023919,138.246802043783,88.7325951938698,70,51,19
10,al022015,06,2015,7917630.84839827,20.0202100920619,19.6415724336355,64,41,23
11,al022016,05,2016,0,1.90199735132478,8.51944662898147,0,0,0
12,al022016,06,2016,0,0.966999809275649,7.98047476184911,0,0,0
13,al022017,06,2017,2807677.02677572,15.1152779616381,31.6051098437501,0,0,0
14,AL022018,07,2018,0,14.3569841983512,67.349898195905,0,0,0
15,AL022019,07,2019,27194691.7951364,32.5340993622667,27.3973470500069,48,25,23
16,AL022020,05,2020,0,0.40809908903384,3.59986409248536,0,0,0
17,AL022021,06,2021,0,12.5687713122688,37.5496777049437,0,0,0
18,AL022022,06,2022,1947653.80404188,42.2923518123142,63.674106869479,0,0,0
19,AL022022,07,2022,6809837.76595609,81.5904505047412,148.134023187379,0,0,0
20,AL022023,06,2023,0,3.93001429497872,9.62492796687287,0,0,0
21,al032014,07,2014,0,4.28798153351255,18.1116075443962,0,0,0
22,al032014,08,2014,6694736.30466689,96.3112090165703,138.886900511857,8,8,0
23,al032015,07,2015,0,19.3166463867392,49.483393356204,0,0,0
24,al032016,06,2016,20615214.7583342,41.7457928482214,38.0393701643122,163,86,77
25,al032017,06,2017,18609374.6351646,50.5044254901093,40.0891284790968,54,28,26
26,AL032018,07,2018,10923680.6212086,430.040300492464,176.845500273019,0,0,0
27,AL032020,06,2020,123212950.495268,140.730953513663,110.710858532616,77,43,34
28,AL032021,06,2021,24707855.1565901,85.2963010298319,94.1354855123499,85,43,42
29,AL032022,07,2022,2819118.61980197,3.66617957897347,9.16010834613033,17,7,10
30,AL032023,06,2023,721506.515371311,48.7761985297925,86.2371945603216,0,0,0
31,al042014,08,2014,73578.0577309379,169.071301840517,97.8514631588552,0,0,0
32,al042015,08,2015,0,26.0106803895788,71.6129688346639,0,0,0
33,al042016,06,2016,1213282.39384686,5.19499516332348,11.9011276455596,0,0,0
34,AL042018,08,2018,0,49.8592897363247,86.6171795912638,0,0,0
35,AL042019,08,2019,0,5.1138095817181,19.6736193769714,0,0,0
36,AL042020,06,2020,0,6.32438331798676,14.6438546080694,0,0,0
37,AL042021,06,2021,0,2.36456304549984,12.0389443749077,0,0,0
38,AL042023,06,2023,0,13.1593313745668,55.0232928377407,0,0,0
39,al052014,09,2014,2769543.55894311,15.8659571671163,21.6256833835872,0,0,0
40,al052015,08,2015,3477351.64335889,60.424773129735,90.6797955344811,9,9,0
41,al052016,08,2016,30136257.9189563,43.2429616254424,62.30430262084,0,0,0
42,al052017,07,2017,0,1.60982948315046,12.0044065668847,0,0,0
43,AL052018,08,2018,28994674.4242469,135.673855155388,147.419754586112,0,0,0
44,AL052019,08,2019,812098.821370697,47.9525449124055,85.7337416313034,2,2,0
45,AL052019,09,2019,45498513.316788,192.050575660024,86.692390841974,152,74,78
46,AL052020,07,2020,0,33.4086529818038,69.7224110084783,0,0,0
47,AL052021,07,2021,59552450.1914479,147.469930597191,206.439556642404,214,109,105
48,AL052022,09,2022,0,240.693297749694,134.978732731029,0,0,0
49,AL052023,07,2023,0,91.8254102942943,125.599751459463,0,0,0
50,al062014,09,2014,0,184.630589056058,123.361669956844,0,0,0
51,al062015,08,2015,479867.686158181,13.4065129269205,24.7778995290958,0,0,0
52,al062015,09,2015,346173.759882412,22.4724320019713,44.6158865045751,0,0,0
53,al062016,08,2016,0,13.7658662500133,59.3073481742232,0,0,0
54,al062017,07,2017,2257080.22116067,2.77814678111758,10.6038700088251,18,10,8
55,AL062018,09,2018,34529907.6244258,182.860637913302,153.79023553005,124,42,82
56,AL062019,08,2019,0,9.69143635097339,21.8206191198167,0,0,0
57,AL062020,07,2020,8833031.43203335,22.7476812171392,23.6418918711117,172,128,44
58,AL062021,08,2021,12065134.075969,20.9817773730837,44.764910564571,12,6,6
59,AL062022,09,2022,11961984.8723427,348.056023118605,130.50191706599,0,0,0
60,AL062023,08,2023,0,2.18938574338705,9.38677693622346,0,0,0
61,AL062023,09,2023,0,10.9248152518131,37.8377127465104,0,0,0
62,al072014,10,2014,15746.1824639535,88.5993702879255,54.7669219593581,0,0,0
63,al072015,09,2015,0,11.9324903121471,39.3014221194612,0,0,0
64,al072016,08,2016,0,116.565378465264,115.680478116142,0,0,0
65,al072016,09,2016,167665.780035961,79.5852763212391,55.391817238637,0,0,0
66,al072017,08,2017,35590560.2647558,59.39805247751,53.1853087134147,0,0,0
67,AL072018,09,2018,8980037.0997731,15.0326207419971,35.5490768845306,36,20,16
68,AL072019,09,2019,2710065.50630798,9.09071697266813,13.8988679224091,0,0,0
69,AL072020,07,2020,0,5.92871258817158,35.654967316896,0,0,0
70,AL072021,08,2021,32892875.3117937,74.5574586585291,86.726253370355,0,0,0
71,AL072022,09,2022,180472227.610843,588.729865058941,209.973743082405,26,19,7
72,AL072023,08,2023,0,31.897316075648,42.6710002074012,0,0,0
73,al082014,10,2014,2870165.33988541,231.808248658989,123.834620552958,0,0,0
74,al082015,09,2015,0,18.4051998379173,21.3516857437138,0,0,0
75,al082017,08,2017,0,104.876013892258,100.85500555406,0,0,0
76,AL082018,09,2018,56399.1043510544,284.405892754838,175.626092277571,0,0,0
77,AL082019,09,2019,0,152.72702997428,146.373904565521,0,0,0
78,AL082020,07,2020,17323005.8993629,19.5925467383211,27.1750513489349,19,10,9
79,AL082021,08,2021,2343269.42880962,64.3660684751978,67.0043957755043,25,18,7
80,AL082022,09,2022,355127.522281431,61.1220547646118,58.5843531681995,0,0,0
81,AL082023,08,2023,7280516.62464065,118.753803251855,96.0513171720564,0,0,0
82,AL082023,09,2023,0,355.892187285916,163.162906725114,0,0,0
83,al092014,10,2014,3236132.65924879,3.5182972843761,8.06870189285036,0,0,0
84,al092016,08,2016,0,6.6080675862554,11.3060970234428,0,0,0
85,al092016,09,2016,56903652.0440219,66.7088505175687,51.5140357494818,194,88,106
86,al092017,08,2017,35622512.062086,51.1918851166963,62.8655047720021,118,69,49
87,AL092018,09,2018,594272.895858133,50.6053182772698,86.97774537146,0,0,0
88,AL092019,09,2019,5515827.79626273,246.331189233272,91.94958635549,0,0,0
89,AL092020,07,2020,19489825.5000772,121.231871454499,70.9877875635642,9,9,0
90,AL092020,08,2020,67510886.0733252,80.2025526484913,93.3810623575037,505,331,174
91,AL092021,08,2021,29973726.6945949,50.6644067779911,51.2100897206585,56,30,26
92,AL092021,09,2021,60392649.3170416,93.5163741322935,69.1742511644863,112,74,38
93,AL092022,09,2022,74500424.7390826,140.559599856588,87.7869112324349,358,182,176
94,AL092022,10,2022,17483284.861073,14.2633812194863,15.1444525355613,63,20,43
95,AL092023,08,2023,6085502.15257988,9.83612595850786,20.8006857120949,6,3,3
96,al102015,09,2015,0,54.7434501770163,47.4580882648299,0,0,0
97,al102016,09,2016,0,141.397584032147,98.354302710642,0,0,0
98,AL102018,09,2018,0,28.8665972713188,52.2312670613561,0,0,0
99,AL102019,09,2019,0,63.438007772901,100.938124735015,0,0,0
100,AL102021,08,2021,0,2.14517609314805,8.16821233295519,0,0,0
101,AL102022,09,2022,0,1.07992152807472,6.65212758510795,0,0,0
102,AL102023,08,2023,62182773.0589213,101.45053522965,66.5463305338281,251,113,138
103,AL102023,09,2023,35469.5045441601,182.82071150607,81.204620688272,0,0,0
104,al112015,09,2015,0,13.5720279772083,16.4918653750293,0,0,0
105,al112015,10,2015,2248495.73466843,373.319650352147,143.02180496036,0,0,0
106,al112016,09,2016,9322696.13983388,13.6034582889542,30.1077154896845,48,25,23
107,al112017,08,2017,0,7.25005590524154,18.4344269173365,0,0,0
108,al112017,09,2017,185711133.296322,298.697534860149,162.856404765182,640,331,309
109,AL112019,09,2019,30646.7913437345,0.673736918101667,3.53215627171332,0,0,0
110,AL112020,08,2020,0,22.2915566478572,48.3313453860604,0,0,0
111,AL112021,08,2021,0,59.8588676879651,86.4778298254979,0,0,0
112,AL112023,08,2023,0,1.61366237572895,8.1849840832668,0,0,0
113,AL112023,09,2023,0,4.13884993698446,15.5159691190218,0,0,0
114,al122015,11,2015,24577.0830635612,67.5120253284907,85.3789649672657,0,0,0
115,al122016,09,2016,15746.1824639535,128.393204855466,131.229582356923,0,0,0
116,al122017,09,2017,1755058.88050821,218.344325922764,143.369842734899,24,15,9
117,AL122018,09,2018,677937.863048671,45.7149710029074,59.7165269012532,0,0,0
118,AL122019,09,2019,629720.792215206,25.7015752808015,70.0111238366775,1,1,0
119,AL122020,08,2020,0,27.0413447567885,44.0159567918226,0,0,0
120,AL122021,09,2021,16541132.4341165,423.11506415939,197.5522473653,0,0,0
121,AL122023,09,2023,0,12.6957046683237,24.9463951553024,0,0,0
122,al132016,09,2016,0,38.1676990792639,54.3673683362287,0,0,0
123,al132017,09,2017,3577485.80173528,7.99470450162187,13.2228812505591,0,0,0
124,AL132018,09,2018,0,234.18082997195,67.4048238338763,0,0,0
125,AL132018,10,2018,23086491.1741401,417.702145780233,158.670412688664,0,0,0
126,AL132019,09,2019,0,215.210747800215,98.8691310866214,0,0,0
127,AL132019,10,2019,44457469.9907027,568.407070891562,125.821317589271,0,0,0
128,AL132020,08,2020,89996844.5028432,174.217102015885,128.19779889958,55,31,24
129,AL132021,09,2021,972811.326922219,1.01091144313568,6.98617496603274,0,0,0
130,AL132022,10,2022,20065006.0004873,28.9736592683333,50.8799256423182,0,0,0
131,AL132023,09,2023,44213246.1008967,356.442455217429,141.949109766911,87,54,33
132,al142016,09,2016,1341047.06096593,66.5805802898398,49.686060083656,0,0,0
133,al142016,10,2016,84268832.8956216,155.224171501536,82.9878230336176,329,155,174
134,al142017,09,2017,0,94.981170630783,115.350213318626,0,0,0
135,AL142018,10,2018,103136092.907838,646.188562270414,250.906667122018,154,64,90
136,AL142019,10,2019,5487929.48901582,87.7143969891592,67.9467957988015,130,91,39
137,AL142020,08,2020,125267.409590339,19.1987182520154,37.1980642431413,0,0,0
138,AL142021,09,2021,15928393.0261977,26.8781922116708,34.5552861447896,75,46,29
139,AL142022,10,2022,1087423.56317803,13.2934785049315,19.4405007594944,0,0,0
140,AL142023,09,2023,0,132.161613882947,86.2879392989596,0,0,0
141,al152016,10,2016,15746.1824639535,389.136949374495,124.50499570913,0,0,0
142,al152017,09,2017,10457420.7045304,321.274042886313,153.358375068618,11,10,1
143,AL152018,10,2018,0,13.1928186827541,25.3241841594815,0,0,0
144,AL152020,09,2020,0,7.67482752495562,26.1069878236322,0,0,0
145,AL152021,09,2021,2137841.41898831,247.017330427876,107.241520927932,0,0,0
146,AL152022,10,2022,0,11.8230102889079,21.8221527540216,0,0,0
147,AL152022,11,2022,5344336.02489702,18.5552879899,42.4313237063061,0,0,0
148,AL152023,09,2023,68822409.5623272,862.031055839117,216.05285988557,0,0,0
149,al162017,10,2017,15011416.161315,40.6822589120414,62.8328013965295,35,18,17
150,AL162018,10,2018,0,150.31518714285,94.0386161232761,0,0,0
151,AL162018,11,2018,79796757.1056287,1138.65191130025,160.077735853821,0,0,0
152,AL162019,10,2019,115380154.537652,120.293379162026,73.6543552454837,491,235,256
153,AL162020,09,2020,6087248.83140854,16.1447315755895,43.1775917107696,0,0,0
154,AL162021,09,2021,0,21.1732717178393,31.9530846830883,0,0,0
155,AL162022,10,2022,0,24.4195303171824,23.3269723272912,0,0,0
156,AL162022,11,2022,16663040.572588,621.361290969773,150.160724884064,0,0,0
157,AL162023,09,2023,32150549.7929855,71.7510686638511,38.6592915425525,237,139,98
158,al172017,10,2017,0,131.408943710266,83.0428607452103,0,0,0
159,AL172019,10,2019,42369998.7252243,29.8580014854515,39.3890346282541,71,37,34
160,AL172020,09,2020,53904.6797916544,458.654062723395,228.859396066618,0,0,0
161,AL172021,09,2021,0,15.8983645742644,34.8804008034367,0,0,0
162,AL172022,11,2022,60748420.9676761,183.362723521724,71.0792995778941,298,167,131
163,AL172023,09,2023,0,73.370152978801,57.6490851325066,0,0,0
164,AL172023,10,2023,1009797.12154267,82.7043223988927,61.4106081218011,1,1,0
165,al182017,10,2017,5731047.97028184,8.57074215396779,12.9266173281352,0,0,0
166,AL182019,10,2019,0,72.3207388720329,104.793987237531,0,0,0
167,AL182020,09,2020,99676.154291809,14.8655193505236,46.3690352365162,0,0,0
168,AL182021,09,2021,0,70.3686005275535,76.5300921818161,0,0,0
169,AL182021,10,2021,0,523.837744251978,153.534229920889,0,0,0
170,AL182023,09,2023,0,21.9848850217968,32.0240663247055,0,0,0
171,AL182023,10,2023,0,2.56559344411698,11.3352967340013,0,0,0
172,AL192017,11,2017,0,66.4675056543036,56.7945139251756,0,0,0
173,AL192019,10,2019,40497.1446402745,360.160950432601,71.3421579015494,0,0,0
174,AL192019,11,2019,40497.1446402745,9.59037257245552,16.83752106378,0,0,0
175,AL192020,09,2020,21828194.5169651,31.599413513728,37.2663162418784,83,52,31
176,AL192021,09,2021,0,8.64609375789507,14.2116073278581,0,0,0
177,AL192023,10,2023,0,11.9930167967089,31.9225246244935,0,0,0
178,AL202019,11,2019,20451558.4088832,284.025143004541,195.046045331251,0,0,0
179,AL202020,09,2020,70134176.7298369,419.010565865963,148.53524810042,7,4,3
180,AL202021,09,2021,0,8.59352734835478,18.2758021692021,0,0,0
181,AL202021,10,2021,0,21.8479861566158,26.0324293512538,0,0,0
182,AL202023,10,2023,989686.889666625,141.217312371228,110.913928032799,0,0,0
183,AL212020,09,2020,0,20.4042148386703,32.0401883240907,0,0,0
184,AL212021,10,2021,86903797.9546111,317.389143419916,114.799124155285,375,259,116
185,AL212021,11,2021,0,48.1977309861649,75.6682862712314,0,0,0
186,AL222020,09,2020,15769172.7137573,33.7059757081627,29.8256769770949,78,49,29
187,AL232020,09,2020,0,32.8449657800538,54.2824838326332,0,0,0
188,AL242020,09,2020,933464.754066929,116.679586801527,76.7694317584106,0,0,0
189,AL252020,10,2020,6414538.35190637,24.0024988535268,27.9003151040055,0,0,0
190,AL262020,10,2020,47766513.4569563,83.5344377548194,65.5769819015843,69,35,34
191,AL272020,10,2020,31411.3822279847,539.036469034424,157.085933630445,0,0,0
192,AL282020,10,2020,108458140.289448,135.803376071875,118.462623995606,566,346,220
193,AL292020,11,2020,60364001.5557186,122.020456615772,153.544083082114,244,139,105
194,AL302020,11,2020,0,108.190669600708,72.6001238886643,0,0,0
195,AL312020,11,2020,40559670.8544755,58.4931874710306,44.2737001950103,0,0,0
196,ep012014,05,2014,0,17.2221555364589,22.5402128057413,0,0,0
197,ep012015,05,2015,0,33.0969091356019,32.7695701599819,0,0,0
198,ep012015,06,2015,0,37.2810392028177,28.8964672451646,0,0,0
199,ep012017,05,2017,0,2.30612753996536,7.00391785845283,0,0,0
200,EP012019,06,2019,0,8.83215591481326,37.2411695502477,0,0,0
201,EP012021,05,2021,0,3.09366162570461,9.11914858480921,0,0,0
202,EP012022,05,2022,7500140.55093368,12.4751770923922,17.0877741156241,0,0,0
203,EP012023,06,2023,0,17.4034123132121,24.0371422031381,0,0,0
204,EP012023,07,2023,5135.38131311503,7.79197446708747,12.3974646020313,0,0,0
205,ep022014,06,2014,1466303.93712935,2.26744535671298,6.28979203688725,0,0,0
206,ep022015,06,2015,13810746.6980155,78.7269137317126,46.4196409918899,0,0,0
207,ep022016,07,2016,0,6.86261725988004,26.2651112637255,0,0,0
208,ep022017,06,2017,259861.821428999,1.48470376864168,5.93069183533437,0,0,0
209,EP022018,06,2018,0,30.8511768789999,33.5327440657577,0,0,0
210,EP022019,06,2019,514.503115833889,10.760974557068,22.2275250655376,0,0,0
211,EP022019,07,2019,0,114.996886741164,84.0592715174811,0,0,0
212,EP022020,05,2020,2219753.416327,1.89761681896846,6.08220107403897,0,0,0
213,EP022021,05,2021,0,0.664273536123687,5.84352510001275,0,0,0
214,EP022021,06,2021,0,3.19858002643116,12.1750302610017,0,0,0
215,EP022022,06,2022,35225.236495426,34.2179686793752,34.1138468579342,0,0,0
216,EP022023,06,2023,2741428.41302114,7.26508091735252,22.9922529789844,0,0,0
217,EP022023,07,2023,6056469.24549754,3.69539537636285,8.68462254649173,0,0,0
218,ep032014,06,2014,35225.236495426,22.7121093214947,31.169816371731,0,0,0
219,ep032015,06,2015,2017135.92128761,15.099998485396,25.3565056987385,0,0,0
220,ep032016,07,2016,0,87.1995152193771,73.1843485505583,0,0,0
221,ep032017,06,2017,644003.943929205,2.10768194721243,6.14207447718082,0,0,0
222,EP032018,06,2018,2283970.24030062,44.0611963115551,43.8954894515047,0,0,0
223,EP032019,07,2019,0,20.1117601840809,22.3632884216607,0,0,0
224,EP032020,06,2020,0,2.01724739374026,7.64520568435477,0,0,0
225,EP032021,06,2021,0,3.15729936637877,15.808472109472,0,0,0
226,EP032022,06,2022,35225.236495426,37.7941103508282,62.6718775314264,0,0,0
227,EP032023,07,2023,1063381.58287935,104.064523538272,136.341606470566,0,0,0
228,ep042014,06,2014,0,11.8558899388703,17.7657170857055,0,0,0
229,ep042014,07,2014,5135.38131311503,13.4320508427735,23.5995151222156,0,0,0
230,ep042015,07,2015,0,8.93062977417367,24.439518249136,0,0,0
231,ep042016,07,2016,0,147.550517431568,143.373346994599,0,0,0
232,ep042017,06,2017,1560.03491192387,16.7567783895521,37.3769376664882,0,0,0
233,EP042018,06,2018,1668158.58175444,3.36539013694346,10.2654880293496,0,0,0
234,EP042021,06,2021,9579850.28024965,15.3700940872604,19.855501473963,0,0,0
235,EP042022,06,2022,1947653.80404188,42.2923518123142,63.674106869479,0,0,0
236,EP042022,07,2022,6809837.76595609,81.5904505047412,148.134023187379,0,0,0
237,ep052014,06,2014,9.83374726759584,4.47118817378077,8.92209595992022,0,0,0
238,ep052014,07,2014,0,2.8374522156704,6.54573439694515,0,0,0
239,ep052015,07,2015,35235.0702426936,80.4739340291553,61.6712751169466,0,0,0
240,ep052016,07,2016,3313292.16031579,119.82167269843,126.83602382414,8,5,3
241,ep052017,07,2017,5135.38131311503,37.1743963486471,39.8322108208717,0,0,0
242,EP052018,06,2018,0,3.52808826653904,15.8196503352951,0,0,0
243,EP052019,07,2019,0,6.29910283629147,11.1125335360275,0,0,0
244,EP052020,07,2020,38800.5828966172,40.2593475903157,65.0496432817536,0,0,0
245,EP052021,06,2021,3216396.87247157,30.8253899989243,35.5273654031474,0,0,0
246,EP052022,07,2022,0,34.5435185074834,117.286464921811,0,0,0
247,EP052023,08,2023,0,118.805517822489,221.362909952397,0,0,0
248,ep062014,07,2014,0,4.59280734158136,18.2720674270657,0,0,0
249,ep062015,07,2015,0,19.5478294202636,36.5209627574728,0,0,0
250,ep062016,07,2016,5135.38131311503,78.732350148574,72.1122017657011,0,0,0
251,ep062017,07,2017,0,74.3593604163755,88.2075579564168,0,0,0
252,EP062018,06,2018,0,14.9384430224482,22.0959553062408,0,0,0
253,EP062019,07,2019,0,34.4475070267915,63.8245621741158,0,0,0
254,EP062019,08,2019,0,25.5231132388899,44.8900032611071,0,0,0
255,EP062021,07,2021,0,28.503597018554,62.1850674031236,0,0,0
256,EP062022,07,2022,38800.5828966172,48.4313709547419,69.1739206654014,0,0,0
257,EP062023,08,2023,0,14.8419299683991,37.7083108769251,0,0,0
258,ep072014,07,2014,0,3.69961897650842,11.8922804115041,0,0,0
259,ep072014,08,2014,0,126.146142655324,98.0154834314998,0,0,0
260,ep072015,07,2015,5135.38131311503,2.99118087766033,8.42669771217862,0,0,0
261,ep072016,07,2016,35225.236495426,37.8396500565377,64.7171741452831,0,0,0
262,ep072017,07,2017,0,29.9528833919744,80.0557241845845,0,0,0
263,EP072018,07,2018,0,90.0050969418186,65.5812673850844,0,0,0
264,EP072019,07,2019,0,26.0298938783113,50.4593720100744,0,0,0
265,EP072019,08,2019,0,61.0718681038835,67.357108589452,0,0,0
266,EP072020,07,2020,0,1.4570419331942,9.73539412392782,0,0,0
267,EP072021,07,2021,5135.38131311503,24.7191153575549,40.4315262534444,0,0,0
268,EP072022,07,2022,0,50.4718339478216,59.4527098058196,0,0,0
269,EP072022,08,2022,0,23.8344140119343,25.2048244049838,0,0,0
270,EP072023,08,2023,0,38.6883539766785,62.9462005359382,0,0,0
271,ep082014,07,2014,11680.3483537298,15.7204421426724,39.7125258782175,0,0,0
272,ep082016,07,2016,0,21.0446686879191,38.1227429226631,0,0,0
273,EP082018,07,2018,0,0.798405812479473,7.205325407738,0,0,0
274,EP082019,08,2019,0,2.15311093618845,7.38985659294839,0,0,0
275,EP082020,07,2020,376075.898660847,103.116984624549,129.345222356943,0,0,0
276,EP082021,07,2021,0,19.7658015848024,26.2838556189001,0,0,0
277,EP082021,08,2021,0,28.6291240189978,41.9671679258133,0,0,0
278,EP082022,07,2022,0,9.27731573429242,42.5013277739707,0,0,0
279,EP082023,08,2023,0,25.7617529246548,45.3476128287589,0,0,0
280,ep092014,07,2014,0,4.02251959062505,8.66427828139455,0,0,0
281,ep092014,08,2014,2691169.90455314,98.1833746458218,102.045702442149,3,2,1
282,ep092015,07,2015,0,24.9587758028562,33.4776903410837,0,0,0
283,ep092015,08,2015,0,78.536516702165,66.4843225530394,0,0,0
284,ep092016,08,2016,0,30.1598051673059,57.8488729149398,0,0,0
285,ep092017,07,2017,5135.38131311503,58.5371445395279,86.9419910380827,0,0,0
286,EP092019,08,2019,0,1.24617603081583,8.14497391506629,0,0,0
287,EP092020,08,2020,1560.03491192387,22.8480975452483,48.530204212749,0,0,0
288,EP092021,08,2021,0,2.28606998292366,11.6123881058226,0,0,0
289,EP092022,08,2022,0,15.935121095703,37.4602280201162,0,0,0
290,EP092023,08,2023,52778743.9822211,158.946583616872,76.368787112252,30,22,8
291,ep102014,08,2014,0,134.236451457081,127.880727500701,0,0,0
292,ep102015,08,2015,0,38.2097594555451,60.0632154038505,0,0,0
293,ep102016,08,2016,0,30.525744764768,65.2497724359127,0,0,0
294,ep102017,07,2017,0,28.0686704092072,47.559965236967,0,0,0
295,ep102017,08,2017,0,2.2769532695711,10.3608961452324,0,0,0
296,EP102018,08,2018,0,155.423537185243,189.468668932661,0,0,0
297,EP102019,08,2019,5135.38131311503,35.116547041681,40.2779960584726,0,0,0
298,EP102021,08,2021,0,2.28255858553666,8.5852096092887,0,0,0
299,EP102022,08,2022,5135.38131311503,1.74025281505055,5.37946911277548,0,0,0
300,EP102023,08,2023,0,21.6414091936464,33.1497921272349,0,0,0
301,ep112014,08,2014,0,44.8111169854642,68.47118628263,0,0,0
302,ep112016,08,2016,6091851.52714241,14.5899223743631,23.8550205591224,0,0,0
303,EP112018,08,2018,44526.5453261344,9.3795124741232,38.4354116553427,0,0,0
304,EP112019,09,2019,5135.38131311503,73.7221214389501,68.5833693303268,0,0,0
305,EP112020,08,2020,0,0.206767481192173,1.83412577231921,0,0,0
306,EP112021,08,2021,5135.38131311503,23.9872468893212,40.2292831839041,0,0,0
307,EP112022,09,2022,35225.236495426,17.8480453068125,31.6613568478071,0,0,0
308,EP112023,09,2023,5135.38131311503,67.8864725511032,63.8327990834741,0,0,0
309,ep122014,08,2014,0,65.4970487924265,38.7569232683739,0,0,0
310,ep122015,08,2015,0,63.0217962961425,59.8221712970239,0,0,0
311,ep122015,09,2015,0,114.567454472274,60.4528602754381,0,0,0
312,ep122016,08,2016,0,10.2879135867415,30.25182691075,0,0,0
313,ep122017,08,2017,0,2.97151213083589,14.0060093806056,0,0,0
314,EP122018,08,2018,35279.8150675648,49.2105400894368,46.8571607974383,0,0,0
315,EP122019,09,2019,0,5.21358711974483,14.1438049219125,0,0,0
316,EP122020,08,2020,4461585.61022496,65.4174087447907,57.7236611374137,0,0,0
317,EP122021,08,2021,5135.38131311503,108.654549364939,105.420019754676,0,0,0
318,EP122022,09,2022,43904892.9153727,124.308207974049,71.5706567691813,31,22,9
319,ep132014,08,2014,40360.6178085411,172.711969557728,94.3413663406483,0,0,0
320,ep132015,08,2015,0,66.7169449821188,56.5859619382693,0,0,0
321,ep132015,09,2015,0,117.902615660026,64.5847688002597,0,0,0
322,ep132016,08,2016,5135.38131311503,63.9241712361995,75.4277150369658,0,0,0
323,ep132016,09,2016,0,106.446257358419,100.25643079891,0,0,0
324,ep132017,08,2017,0,46.7540314593391,69.2166510348763,0,0,0
325,EP132018,08,2018,0,17.9433039013455,45.717151403281,0,0,0
326,EP132019,09,2019,0,35.5974083703766,77.9832468565736,0,0,0
327,EP132020,08,2020,342516.589544981,11.1251100923189,23.4984303270759,0,0,0
328,EP132021,08,2021,1560.03491192387,8.80349698653117,26.1748609181384,0,0,0
329,EP132022,09,2022,0,3.60878769599219,12.236452777963,0,0,0
330,EP132023,09,2023,0,10.5209713225885,25.6395534847632,0,0,0
331,ep142014,09,2014,8805832.71976893,45.8905790045646,44.0419289277192,0,0,0
332,ep142015,09,2015,0,20.0966963542721,46.2277745241777,0,0,0
333,ep142016,08,2016,0,40.5374060687261,47.1142521247018,0,0,0
334,ep142016,09,2016,0,6.94429242666229,16.5290100547795,0,0,0
335,ep142017,08,2017,1752198.12863758,18.8596109467728,20.4660477481766,0,0,0
336,ep142017,09,2017,30647795.0530977,38.1976064854516,30.0702962307533,0,0,0
337,EP142018,08,2018,29083.8946764733,99.8263969149491,121.403895099531,0,0,0
338,EP142019,09,2019,35225.236495426,17.3932903636463,30.6415772498456,0,0,0
339,EP142020,08,2020,5135.38131311503,13.1882732283273,22.7892107837434,0,0,0
340,EP142021,08,2021,27690807.2855542,69.6182918497253,42.1377029061475,0,0,0
341,EP142022,09,2022,0,39.8942682204444,31.8529005684493,0,0,0
342,ep152014,09,2014,41081927.1800972,93.3738670507888,52.4451530376435,0,0,0
343,ep152015,09,2015,33719.7801556409,47.0707182082003,43.0896368179325,0,0,0
344,ep152016,09,2016,45811465.7645422,64.5789457665423,47.0626882246517,0,0,0
345,ep152017,09,2017,0,8.58741463455624,17.7357243232061,0,0,0
346,EP152018,08,2018,0,39.651574530595,61.7078400489747,0,0,0
347,EP152018,09,2018,0,18.5842929672463,25.0967875281811,0,0,0
348,EP152019,09,2019,6469261.71591624,25.7638526299324,55.8815683911364,0,0,0
349,EP152020,09,2020,0,2.44731122384724,19.5114626457485,0,0,0
350,EP152021,09,2021,4882570.1111571,18.0658138985493,24.325594294299,0,0,0
351,EP152022,09,2022,33665.2015835022,7.33006756149655,21.3540675563856,0,0,0
352,EP152023,10,2023,16215972.5781324,43.5744398103133,53.666878406049,0,0,0
353,ep162016,09,2016,0,29.6949449927992,39.1881463921521,0,0,0
354,ep162017,09,2017,3855358.57608105,4.05361649788472,11.0548465329775,0,0,0
355,EP162018,08,2018,0,19.1747299627859,28.1644118506159,0,0,0
356,EP162018,09,2018,0,123.42081852003,109.094773601419,0,0,0
357,EP162019,09,2019,11478816.2283729,15.8727442611105,39.8325324896691,0,0,0
358,EP162019,10,2019,1480921.36520472,1.33688403766564,5.39834827961417,0,0,0
359,EP162020,09,2020,0,35.4120290879149,35.1051098805555,0,0,0
360,EP162021,10,2021,14896109.7999979,31.126950207497,44.0702462435535,0,0,0
361,EP162022,09,2022,0,3.37821676130307,14.2321552830908,0,0,0
362,EP162022,10,2022,6365129.48135945,15.8343872150551,20.6084590977738,0,0,0
363,EP162023,10,2023,3534836.62407262,4.03931395694724,8.38379029034958,0,0,0
364,ep172014,09,2014,16608.9047874594,39.1089606276227,54.3881023287706,0,0,0
365,ep172015,09,2015,227110.585407215,13.0973896097879,19.4754503018086,0,0,0
366,ep172016,09,2016,54.5785721387303,28.1811674084216,41.2192890925485,0,0,0
367,ep172017,09,2017,35225.236495426,17.8700980605224,20.8468653788265,0,0,0
368,EP172018,09,2018,558268.742058157,126.006054869091,133.796863532693,5,3,2
369,EP172020,09,2020,5135.38131311503,35.9373628705522,48.7703071470875,0,0,0
370,EP172021,10,2021,8387051.87453844,12.214085643331,19.4424343461475,0,0,0
371,EP172022,10,2022,0,3.26910923854848,9.84304713591547,0,0,0
372,EP172023,10,2023,14530168.820906,58.6789594131542,42.0018835482424,0,0,0
373,ep182014,09,2014,38800.5828966172,33.3700777688333,39.1701640500057,0,0,0
374,ep182015,10,2015,0,13.8504300428268,41.9072842817143,0,0,0
375,ep182016,09,2016,0,20.0016925414324,22.9287839747359,0,0,0
376,ep182017,09,2017,459752.31486425,4.02528465036664,14.6080881253927,0,0,0
377,EP182018,09,2018,0,11.7466632927742,26.6884543015997,0,0,0
378,EP182019,10,2019,0,1.66107095344898,6.26444091243725,0,0,0
379,EP182020,09,2020,0,4.13729124443375,16.6226648454004,0,0,0
380,EP182020,10,2020,0,75.8029415721977,66.0962824304653,0,0,0
381,EP182021,11,2021,0,5.13504393826753,12.567080772734,0,0,0
382,EP182022,10,2022,20065006.0004873,28.9736592683333,50.8799256423182,0,0,0
383,EP182023,10,2023,8939702.62805185,14.1765670699821,27.0336730137634,0,0,0
384,ep192014,10,2014,271449.728979215,39.6946052378011,51.5252403946947,0,0,0
385,ep192015,10,2015,0,141.945166363038,104.33372667785,0,0,0
386,ep192016,09,2016,0,8.0072424323173,21.2318787104455,0,0,0
387,ep192017,10,2017,0,1.88260927326348,6.57709056509513,0,0,0
388,EP192019,10,2019,16016.8621615155,0.791368431401679,5.9221274843082,0,0,0
389,EP192020,10,2020,0,5.822737117869,25.5002018798384,0,0,0
390,EP192021,11,2021,0,7.61196159679696,14.1792785840617,0,0,0
391,EP192022,10,2022,12668542.0963772,21.6406296281612,34.7523641593832,0,0,0
392,EP192023,10,2023,0,6.5048267271863,11.6388416828474,0,0,0
393,EP192023,11,2023,514.503115833889,28.3570164717964,69.2056618397352,0,0,0
394,ep202014,10,2014,2480064.33496436,3.49596923088825,8.8426109001285,0,0,0
395,ep202015,10,2015,57586532.458465,68.3998624473102,57.977531409177,0,0,0
396,ep202016,10,2016,0,35.7284058563507,62.9053219351919,0,0,0
397,ep202017,10,2017,317769.526156458,2.21061995005869,9.98207578208926,0,0,0
398,EP202018,09,2018,5135.38131311503,59.2366078758114,53.6378775202428,0,0,0
399,EP202018,10,2018,1519644.05526127,20.1098289612082,19.1015618325674,0,0,0
400,EP202019,11,2019,0,16.3812311463819,18.9847624444499,0,0,0
401,EP202020,11,2020,0,29.9374158867927,37.1282870915086,0,0,0
402,EP202023,11,2023,0,1.97594661914013,8.80112047187952,0,0,0
403,ep212014,10,2014,0,3.07871458429736,8.70177845902436,0,0,0
404,ep212014,11,2014,33665.2015835022,40.7610685890916,47.1868585577586,0,0,0
405,ep212015,11,2015,0,8.24259707955639,30.8724315695872,0,0,0
406,ep212016,11,2016,0,5.16219847558443,9.58689800179721,0,0,0
407,EP212018,09,2018,0,20.1707047008557,21.3068839428952,0,0,0
408,EP212018,10,2018,10554948.5225362,170.191211874583,96.5574074765943,0,0,0
409,EP212020,11,2020,0,1.48366736544631,12.4078768484902,0,0,0
410,ep222015,11,2015,204.592522318178,41.5987825598496,46.3417374191638,0,0,0
411,ep222016,11,2016,8805263.21300906,18.3750484831692,38.4434626922196,0,0,0
412,EP222018,10,2018,7.48526939235014,1.54088639003123,5.81948015878917,0,0,0
413,EP232018,10,2018,0,6.9185068971334,33.5694785924354,0,0,0
414,EP242018,10,2018,11219738.0685267,24.9446167886872,26.8472177986807,0,0,0
415,EP252018,11,2018,4539320.29194791,20.5147608117842,28.101100035298,0,0,0
416,,,,,,,,,
